0 2 2 3 2 2 3 1 0
3 2 0 0 0 0 0 3 1
-9 0 0 0 0 0 0 0 -9
1 1 0 0 0 0 0 2 1
0 1 2 2 3 2 3 1 0
